{
  "rooms": [
    {
      "id": "room1",
      "layout": [
        "############################",
        "#..C......................D#",
        "#..........................#",
        "#..........................#",
        "#..........................#",
        "#..........................#",
        "#..........................#",
        "#..........................#",
        "#..........................#",
        "#..........................#",
        "#..P.......................#",
        "############################"
      ]
    }
  ]
}
