{
  "rooms": [
    {
      "id": "room1",
      "layout": [
        "############################",
        "#..C.......................#",
        "#..........................#",
        "#.......................T..#",
        "#..........................#",
        "#............ME............#",
        "#....D.....................#",
        "#..........................#",
        "#..........................#",
        "#..........................#",
        "#..P.......................#",
        "############################"
      ]
    },
    {
      "id": "room2",
      "layout": [
        "############################",
        "#..C.......................#",
        "#....................EM....#",
        "#..........................#",
        "#..........................#",
        "#..........................#",
        "#..........................#",
        "#..........................#",
        "#..........................#",
        "#..........................#",
        "#..D.......................#",
        "############################"
      ]
    }
  ]
}
